#####################
#@.$-..$....$$.$$.$.#
#.#$#.#.#.#.#.#.#.#.#
#$..$$....$...$.$.$.#
#$#.#$#.#$#.#$#$#.#.#
#..$.$.$...$..$.....#
#.#.#.#$#.#.#.#.#.#.#
#..........$..$$....#
#.#.#.#.#$#$#.#.#.#$#
#.......$.$.$.......#
#$#.#.#.#$#.#.#.#.#.#
#$.$.$.....$........#
#####################