#####################
#@.$...$....$$.$$.$.#
#.#$#.#.#.#.#.#.#.#.#
#$..$$....$-..$.$.$.#
#$#.#$#.#$#.#$#$#.#.#
#..$.$.$...$..$.....#
#.#.#.#$#.#.#.#.#.#.#
#..........$..$$....#
#.#.#.#.#$#$#.#.#.#$#
#.......$.$.$.......#
#$#|#.#.#$#.#.#.#.#.#
#$.$.$.....$-.......#
#####################